11111111111111111111111111111111111111111111111111111111111111111
100000000C0000000000000000010000000010001010101010101010101010101
100000E00110000000100000000000000000000000000000000000C0000000001
10000000011100000001000000000000000000000000000000000000000P00001
11111111111111111111111111111111111111111111111111111111111111111
