1111111
1CEC001
11C00C1
1P00001
1111111
